###########
#S...#....#
#.##.#.##.#
#....#....#
####.###.##
#......#..#
#.####.#..#
#.#....##.#
#.#.##....#
#...##..G.#
###########
