###########
#S   #    #
# ## # ## #
#    #    #
#### ### ##
#      #  #
# #### #  #
# #    ## #
# # ##    #
#   ##  G #
###########
